111111111111111111111111111111111111111111111
1000000000000000000000000000000000000000000E1
100000000000000000000000000000000000000000001
1         10000000000000000111000000000000000
100000000000000001010000000000000000000     1
10000000000000000000000C000000000000000111111
1000000000000000000               00000000001
100000000000000000000000000001110000000000001
100000000000000000000000000001010000000000001
1P0000000000000000000000000000000000000000001
111111111111111111111111111111111111111111111
