111111111111111111111111111111111111111111111
1000000000000000000000000000000000000000000E1
100000000000000000000000000000000000000000001
100000000000000000000000000000000000000000001
100000000000000000000000000000000000000000001
10000000000000000000000C000000000000000000001
100000000000000000000000000000000000000000001
100000000000000000000000000000000000000000001
100000000000000000000000000000000000000000001
1P0000000000000000000000000000000000000000001
111111111111111111111111111111111111111111111
